aed	दिराम
afn	अफगानी
all	लेक
amd	द्राम
ang	गिल्डर
aoa	क्वान्जा
ars	पेसो
aud	डलर
awg	फ्लोरिन
azn	मनात
bam	मार्क
bbd	डलर
bdt	टाका
bgn	लेभ
bhd	दिनार
bif	फ्राङ्क
bmd	डलर
bnd	डलर
bob	बोलिभियानो
brl	रियल्स
bsd	डलर
btn	गुलट्रम
bwp	पुला
byr	रुबल
bzd	डलर
cad	डलर
cdf	फ्र्याङ्क
chf	फ्र्याङ्क
clp	पेसो
cny	युआन
cop	पेसो
crc	कोलोन
cup	पेसो
cve	स्कुडो
czk	कोरुना
djf	फ्र्याङ्क
dkk	क्रोन
dop	पेसो
dzd	दिनार
egp	पाउन्ड
ern	नाक्फा
etb	बिर
eur	युरो
fjd	डलर
fkp	पाउन्ड
gbp	पाउन्ड
gel	लारी
ghs	सेडी
gip	पाउन्ड
gmd	डालासी
gnf	फ्र्याङ्क
gtq	क्वेटजल
gyd	डलर
hkd	डलर
hnl	लेम्पिरा
hrk	कुना
htg	गोर्दे
huf	फोरिन्ट
idr	रुपिहा
ils	सेकेल
inr	रुपैयाँ
iqd	दिनार
irr	रियाल
jpy	येन
krw	वन
kzt	तेङ्गे
lak	किप
lbp	पाउन्ड
lkr	रुपी
lrd	डलर
lsl	लोती
ltl	लितास
lvl	लात्स
lyd	दिनार
mad	दिराम
mdl	लेउ
mga	आरियारी
mkd	दिनार
mmk	क्यात
mnt	तुग्रिक
mop	पताका
mro	औगुइया
mur	रुपी
mvr	रफिया
mwk	क्वाचा
mxn	पेसो
myr	रिन्गिट
mzn	मेटिकलl
nad	डलार
ngn	नाइरा
nio	ओरो
nok	क्रोन
npr	रुपैयाँ
nzd	डलर
omr	रियाल
pab	बाल्बोआ
pen	सोल
pgk	किना
php	पेसो
pkr	रुपियाँ
pln	ज्लोटी
pyg	गुरानी
qar	रियाल
ron	लेउ
rsd	दिनार
rub	रुबल
rwf	फ्र्याङ्क
sar	रियाल
sbd	डलर
scr	रुपियाँ
sdg	पाउन्ड
sek	क्रोना
sgd	डलार
shp	पाउन्ड
sll	लिओन
sos	सिलिङ
srd	डलर
ssp	पाउन्ड
std	डोब्रा
syp	पाउन्ड
szl	लिलान्गेनी
thb	भाट
tjs	सोमोनी
tmt	मनात
tnd	दिनार
top	पाआङ्गा
try	लिरा
ttd	डलर
twd	डलर
tzs	सिलिङ
uah	ह्रिभ्निया
ugx	सिलिङ
usd	डलर
uyu	पेसो
uzs	सोम
vef	फुएर्टे
vnd	डोङ
vuv	भातु
wst	ताला
xag	सिल्भर आउन्स
xau	गोल्ड आउन्स
xcd	डलर
xpd	पाल्लाडियम आउन्स
xpf	फ्र्याङ्क
xpt	प्लाटिनम आउन्स
yer	रियाल
zar	र्‍यान्ड
zmw	क्वाचा
zwl	डलर
