ЁЯАД	mahjong tile
ЁЯГП	 ржЧрзЛрж▓рж╛ржПрж░ ржкрж╛рждрж╛
ЁЯЕ░	рж░ржХрзНрждрзЗрж░ ржЧрзНрж░рзБржк a_letter
ЁЯЕ▒	рж░ржХрзНрждрзЗрж░ ржЧрзНрж░рзБржк b_letter
ЁЯЕ╛	рж░ржХрзНрждрзЗрж░ ржЧрзНрж░рзБржк o_letter
ЁЯЕ┐	parking
ЁЯЖО	рж░ржХрзНрждрзЗрж░ ржЧрзНрж░рзБржк ab
ЁЯЖС	c_letter l_letter
ЁЯЖТ	ржарж╛ржирзНржбрж╛
ЁЯЖУ	ржмрж┐ржирж╛ржорзВрж▓рзНржпрзЗ
ЁЯЖФ	i_letter d_letter
ЁЯЖХ	ржирждрзБржи
ЁЯЖЦ	ng
ЁЯЖЧ	okay
ЁЯЖШ	s_letter o_letter s_letter
ЁЯЖЩ	ржЙржкрж░
ЁЯЖЪ	ржмржирж╛ржо
ЁЯЗж	region letter a_letter
ЁЯЗз	region letter b_letter
ЁЯЗи	region letter c_letter
ЁЯЗй	region letter d_letter
ЁЯЗк	region letter e_letter
ЁЯЗл	region letter f_letter
ЁЯЗм	region letter g_letter
ЁЯЗн	region letter h_letter
ЁЯЗо	region letter i_pronoun
ЁЯЗп	region letter j_letter
ЁЯЗ░	region letter k_letter
ЁЯЗ▒	region letter l_letter
ЁЯЗ▓	region letter m_letter
ЁЯЗ│	region letter n_letter
ЁЯЗ┤	region letter o_letter
ЁЯЗ╡	region letter p_letter
ЁЯЗ╢	region letter q_letter
ЁЯЗ╖	region letter r_letter
ЁЯЗ╕	region letter s_letter
ЁЯЗ╣	region letter t_letter
ЁЯЗ║	region letter u_letter
ЁЯЗ╗	region letter v_letter
ЁЯЗ╝	region letter w_letter
ЁЯЗ╜	region letter x_letter
ЁЯЗ╛	region letter y_letter
ЁЯЗ┐	region letter z_letter
ЁЯИБ	ржЬрж╛ржкрж╛ржирж┐ рж╢ржмрзНржж
ЁЯИВ	ржЬрж╛ржкрж╛ржирж┐ рж╢ржмрзНржж
ЁЯИЪ	ржЬрж╛ржкрж╛ржирж┐ рж╢ржмрзНржж
ЁЯИп	ржЬрж╛ржкрж╛ржирж┐ рж╢ржмрзНржж
ЁЯИ▓	ржЬрж╛ржкрж╛ржирж┐ рж╢ржмрзНржж
ЁЯИ│	ржЪрзАржирж╛ рж╢ржмрзНржж
ЁЯИ┤	ржЪрзАржирж╛ рж╢ржмрзНржж
ЁЯИ╡	ржЪрзАржирж╛ рж╢ржмрзНржж
ЁЯИ╢	ржЬрж╛ржкрж╛ржирж┐ рж╢ржмрзНржж
ЁЯИ╖	ржЬрж╛ржкрж╛ржирж┐ рж╢ржмрзНржж
ЁЯИ╕	ржЪрзАржирж╛ рж╢ржмрзНржж
ЁЯИ╣	ржЬрж╛ржкрж╛ржирж┐ рж╢ржмрзНржж
ЁЯИ║	ржЪрзАржирж╛ рж╢ржмрзНржж
ЁЯЙР	ржЬрж╛ржкрж╛ржирж┐ рж╢ржмрзНржж
ЁЯЙС	ржЪрзАржирж╛ рж╢ржмрзНржж
ЁЯМА	ржШрзВрж░рзНржгрж┐ржЭржбрж╝
ЁЯМБ	ржХрзБржпрж╝рж╛рж╢рж╛ржЪрзНржЫржирзНржи
ЁЯМВ	ржЫрж╛рждрж╛
ЁЯМГ	рж░рж╛рждрзЗрж░ рждрж╛рж░рж╛
ЁЯМД	рж╕рзВрж░рзНржпрзЛржжржпрж╝
ЁЯМЕ	рж╕рзВрж░рзНржпрж╛рж╕рзНржд
ЁЯМЖ	рж╕ржирзНржзрзНржпрж╛ ржмрзЗрж▓рж╛ржП рж╢рж╣рж░
ЁЯМЗ	рж╕рзВрж░рзНржпрж╛рж╕рзНржд
ЁЯМИ	рж░рж╛ржоржзржирзБ
ЁЯМЙ	рж░рж╛рждрзЗ рж╕рзЗрждрзБ
ЁЯМК	рждрж░ржЩрзНржЧ
ЁЯМЛ	ржЖржЧрзНржирзЗржпрж╝ржЧрж┐рж░рж┐
ЁЯММ	ржпржоржЬрж╛ржВржЧрж▓
ЁЯМН	ржкрзГржерж┐ржмрзА
ЁЯМО	ржкрзГржерж┐ржмрзА
ЁЯМП	ржкрзГржерж┐ржмрзА
ЁЯМР	ржкрзГржерж┐ржмрзА
ЁЯМС	ржЕржорж╛ржмрж╕рзНржпрж╛
ЁЯМТ	ржЕрж░рзНржзржЪржирзНржжрзНрж░
ЁЯМУ	ржЕрж░рзНржз┬аржЪржирзНржжрзНрж░
ЁЯМФ	ржХрзБржмрзНржЬ ржЪрж╛ржБржж
ЁЯМХ	ржкрзВрж░рзНржирж┐ржорж╛
ЁЯМЦ	ржХрзБржмрзНржЬ ржЪрж╛ржБржж
ЁЯМЧ	ржЕрж░рзНржз┬аржЪржирзНржжрзНрж░
ЁЯМШ	ржЕрж░рзНржзржЪржирзНржжрзНрж░
ЁЯМЩ	ржЕрж░рзНржзржЪржирзНржжрзНрж░
ЁЯМЪ	ржЕржорж╛ржмрж╕рзНржпрж╛рж░ ржЪрж╛ржБржж┬а
ЁЯМЫ	ржЕрж░рзНржзрзНржЪрж╛ржирзНржжрзНрж░ржорзБржЦрзА
ЁЯМЬ	ржЕрж░рзНржзрзНржЪрж╛ржирзНржжрзНрж░ржорзБржЦрзА
ЁЯМЭ	ржкрзВрж░рзНржирж┐ржорж╛рж░ ржЪрж╛ржБржжрзЗрж░ ржЪрзЗрж╣рж╛рж░рж╛
ЁЯМЮ	рж╕рзВрж░рзНржпрзЗрж░ ржорзБржЦ
ЁЯМЯ	ржЙржЬрзНржЬрзНржмрж▓ рждрж╛рж░рж╛
ЁЯМа	ржЙрж▓рзНржХрж╛
ЁЯМ░	ржУржХ
ЁЯМ▒	ржЪрж╛рж░рж╛ржЧрж╛ржЫ
ЁЯМ▓	ржЪрж┐рж░рж╢рзНржпрж╛ржорж▓ ржЧрж╛ржЫ
ЁЯМ│	ржкрждржирж╢рзАрж▓ ржЧрж╛ржЫ
ЁЯМ┤	рждрж╛рж▓ ржЧрж╛ржЫ
ЁЯМ╡	ржХрзНржпрж╛ржХржЯрж╛рж╕
ЁЯМ╖	tulip
ЁЯМ╕	cherry blossom
ЁЯМ╣	ржЧрзЛрж▓рж╛ржк
ЁЯМ║	hibiscus
ЁЯМ╗	рж╕рзВрж░рзНржпржорзБржЦрзА
ЁЯМ╝	ржкрзБрж╖рзНржкржХрж╛рж▓
ЁЯМ╜	ржнрзБржЯрзНржЯрж╛
ЁЯМ╛	рж╢рж╕рзНржп
ЁЯМ┐	ржФрж╖ржзрж┐
ЁЯНА	ржЪрж╛рж░ ржкрж╛рждрж╛ рждрзНрж░рж┐ржкрждрзНрж░
ЁЯНБ	ржорзНржпрж╛ржкрзЗрж▓рзЗрж░ ржкрж╛рждрж╛
ЁЯНВ	ржкрж╛рждрж╛ ржЭрж░рж╛
ЁЯНГ	ржмрж╛рждрж╛рж╕рзЗ ржкрж╛рждрж╛
ЁЯНД	mushroom
ЁЯНЕ	ржЯржорзЗржЯрзЛ
ЁЯНЖ	ржмрзЗржЧрзБржи
ЁЯНЗ	ржЖржВржЧрзБрж░┬а
ЁЯНИ	рждрж░ржорзБржЬ
ЁЯНЙ	рждрж░ржорзБржЬ
ЁЯНК	ржорж╛ржиржбрж╛рж░рж┐ржи
ЁЯНЛ	рж▓рзЗржмрзБ
ЁЯНМ	ржХрж▓рж╛
ЁЯНН	ржЖржирж╛рж░рж╕┬а
ЁЯНО	рж▓рж╛рж▓ ржЖржкрзЗрж▓
ЁЯНП	рж╕ржмрзБржЬ ржЖржкрзЗрж▓
ЁЯНР	ржирж╛рж╢ржкрж╛рждрж┐
ЁЯНС	ржЦрзЛржБржбрж╝рж╛
ЁЯНТ	cherry
ЁЯНУ	strawberry
ЁЯНФ	hamburger
#ЁЯНХ	pizza рдХрд╛ рдЯреБрдХрдбрд╝рд╛
ЁЯНЦ	ржорж╛ржВрж╕
ЁЯНЧ	ржорзБрж░ржЧрж┐рж░ ржкрж╛
ЁЯНШ	ржнрж╛рждрзЗрж░ ржмрж▓
ЁЯНЩ	ржнрж╛рждрзЗрж░ ржмрж▓
ЁЯНЪ	ржнрж╛ржд
ЁЯНЫ	ржЭрзЛрж▓ ржЖрж░ ржнрж╛ржд
ЁЯНЬ	ramen
ЁЯНЭ	spaghetti
ЁЯНЮ	bread
ЁЯНЯ	fries
ЁЯНа	рж░рзЛрж╕рзНржЯ ржХрж░рж╛ ржЖрж▓рзБ
ЁЯНб	mochi
ЁЯНв	oden
ЁЯНг	sushi
ЁЯНд	ржнрж╛ржЬрж╛ ржЪрж┐ржВржбрж╝рж┐ ржорж╛ржЫ
ЁЯНе	fish cake
ЁЯНж	ржирж░ржо ice cream
ЁЯНз	ржмрж░ржл
ЁЯНи	ice cream
ЁЯНй	donut
ЁЯНк	ржмрж┐рж╕ржХрзБржЯ
ЁЯНл	chocolate
ЁЯНм	ржЯржлрж┐
ЁЯНн	ржЪрзБржЗржВ ржЧрж╛ржо
ЁЯНо	custard
ЁЯНп	ржоржзрзБрж░ ржЬрж╛рж░
ЁЯН░	shortcake
ЁЯН▒	bento
ЁЯН▓	stew
ЁЯН│	ржХржбрж╝рж╛ржЗ
ЁЯН┤	ржЫрзБрж░рж┐ ржПржмржВ ржХрж╛ржБржЯрж╛ржЪрж╛ржоржЪ
ЁЯН╡	ржЪрж╛ ржПрж░ ржХрж╛ржк
ЁЯН╢	sake
ЁЯН╖	wine
ЁЯН╕	cocktail
ЁЯН╣	tropical drink
ЁЯН║	beer
#ЁЯН╗	beer рдХрд╛ ржкржпрж╝рж╛рд▓рд╛
ЁЯН╝	ржмрж╛ржЪрзНржЪрж╛рж░ ржмрзЛрждрж▓
ЁЯОА	ribbon
ЁЯОБ	ржЙржкрж╣рж╛рж░
ЁЯОВ	ржЬржирзНржоржжрж┐ржирзЗрж░ ржХрзЗржХ
ЁЯОГ	jack o_letter lantern
ЁЯОД	ржмржбрж╝ржжрж┐ржирзЗрж░ ржЧрж╛ржЫ
ЁЯОЕ	santa
ЁЯОЖ	ржмрзЛржорж╛ржмрж╛ржЬрж┐┬а
ЁЯОЗ	ржлрзБрж▓ рж▓рж╛ржарж┐
ЁЯОИ	ржорзЗржШ
ЁЯОЙ	ржЙрждрзНрж╕ржм
ЁЯОК	confetti
ЁЯОЛ	tree and paper strips
ЁЯОМ	ржкрждрж╛ржХрж╛ржП
ЁЯОН	pine decoration
ЁЯОО	ржкрзБрждрзБрж▓ ржЧрзБрж▓рзЛ
ЁЯОП	ржХрж╛рж░рзНржкрзЗрж░ ржкрждрж╛ржХрж╛
ЁЯОР	wind_nou chime
ЁЯОС	ржЪрж╛ржБржж ржХрзЗ ржжрзЗржЦрж╛
ЁЯОТ	рж╕рзНржХрзБрж▓рзЗрж░ ржмрзНржпрж╛ржЧ
ЁЯОУ	graduation cap
ЁЯОа	ржжрзЛрж▓ржирж╛
ЁЯОб	ржмржбрж╝рзЛ ржирж╛ржЧрж░ржжрзЛрж▓рж╛
ЁЯОв	roller coaster
ЁЯОг	ржорж╛ржЫ ржзрж░рж╛
ЁЯОд	mic
ЁЯОе	ржЪрж▓ржЪрзНржЪрж┐рждрзНрж░рзЗрж░ ржХрзНржпрж╛ржорзЗрж░рж╛
ЁЯОж	рж╕рж┐ржирзЗржорж╛
ЁЯОз	headphone
ЁЯОи	ржЪрж┐рждрзНрж░рж╢рж┐рж▓рзНржкрзАрж░ рж░ржВ ржорзЗрж╢рж╛ржирзЛрж░ ржкрзНржпрж╛рж▓рзЗржЯ
ЁЯОй	Cap
ЁЯОк	circus
ЁЯОл	ржЯрж┐ржХрж┐ржЯ
ЁЯОм	clapperboard
ЁЯОн	ржорзБржЦрзЛрж╕
ЁЯОо	video game
ЁЯОп	bull's eye
ЁЯО░	slot machine
ЁЯО▒	billiard
ЁЯО▓	ржкрж╛рж╢рж╛
ЁЯО│	bowling
ЁЯО┤	рждрж╛рж╕
ЁЯО╡	рж╕рзНржмрж░
ЁЯО╢	рж╕рзНржмрж░
ЁЯО╖	sax
ЁЯО╕	guitar
ЁЯО╣	piano
ЁЯО║	trumpet
ЁЯО╗	violin
ЁЯО╝	music score
ЁЯО╜	ржжрзМржбрж╝рж╛ржмрж╛рж░ рж╢рж╛рж░рзНржЯ
ЁЯО╛	tennis
ЁЯО┐	ski
ЁЯПА	basketball
ЁЯПБ	ржЫржХржХрж╛ржЯрж╛ ржкрждрж╛ржХрж╛
ЁЯПВ	рж╕рзНржирзЛржмрзЛрж░рзНржбрж┐ржВ ржХрж░рж╛рж░ рж▓рзЛржХ
ЁЯПГ	ржжрзМржбрж╝ржмрж╛ржЬ
ЁЯПД	рж╕ржорзБржжрзНрж░рзЗ рж╕рж╛рж░рзНржлрж┐ржВ
ЁЯПЖ	trophy
ЁЯПЗ	ржШрзЛржбрж╝рж╛рж░ рж░рзЗрж╕ ржкрзНрж░рждрж┐ржпрзЛржЧрж┐рждрж╛
ЁЯПИ	ржЖржорзЗрж░рж┐ржХрж╛ржи┬аржлрзБржЯржмрж▓┬а
ЁЯПЙ	ржлрзБржЯржмрж▓
ЁЯПК	рж╕рж╛ржБрждрж╛рж░рзБ
ЁЯПа	ржмрж╛ржбрж╝рж┐
ЁЯПб	ржмрж╛ржбрж╝рж┐
ЁЯПв	ржЕржлрж┐рж╕ ржнржмржи
ЁЯПг	ржбрж╛ржХржШрж░
ЁЯПд	ржбрж╛ржХржШрж░
ЁЯПе	рж╣рж╛рж╕ржкрж╛рждрж╛рж▓┬а
ЁЯПж	bank
ЁЯПз	a_letter t_letter m_letter
ЁЯПи	рж╣рзЛржЯрзЗрж▓
ЁЯПй	ржкрзНрж░рзЗржорзЗрж░ рж╣рзЛржЯрзЗрж▓
ЁЯПк	рж╕рзБржмрж┐ржзрж╛рж░рзНржерзЗ ржжрзЛржХрж╛ржи
ЁЯПл	рж╕рзНржХрзБрж▓
ЁЯПм	рж╕рзБржкрж╛рж░ржорж╛рж░рзНржХрзЗржЯ
ЁЯПн	ржХрж╛рж░ржЦрж╛ржирж╛
ЁЯПо	рж▓ржгрзНржаржи
ЁЯПп	ржЬрж╛ржкрж╛ржирж┐ ржорж╣рж▓
ЁЯП░	ржЗржЙрж░рзЛржкрзЗрж░ ржкрзНрж░рж╛рж╕рж╛ржж
ЁЯРА	ржЗржирзНржжрзБрж░
ЁЯРБ	ржЗржирзНржжрзБрж░
ЁЯРВ	ржмрзГрж╖
ЁЯРГ	ржорзЛрж╖
ЁЯРД	ржЧрж░рзБ
ЁЯРЕ	ржмрж╛ржШ
ЁЯРЖ	ржЪрж┐рждрж╛ржмрж╛ржШ
ЁЯРЗ	ржЦрж░ржЧрзЛрж╢
ЁЯРИ	ржмрж┐ржбрж╝рж╛рж▓
ЁЯРЙ	dragon
ЁЯРК	ржХрзБржорж┐рж░
ЁЯРЛ	рждрж┐ржорж┐
ЁЯРМ	рж╢рж╛ржорзБржХ
ЁЯРН	рж╕рж╛ржБржк
ЁЯРО	ржШрзЛржбрж╝рж╛
ЁЯРП	ржнрзЗржбрж╝рж╛
ЁЯРР	ржЫрж╛ржЧрж▓
ЁЯРС	ржнрзЗржбрж╝рж╛
ЁЯРТ	ржмрж╛ржирзНржжрж░
ЁЯРУ	ржорзЛрж░ржЧ
ЁЯРФ	ржорзБрж░ржЧрж┐
ЁЯРХ	ржХрзБржХрзБрж░
ЁЯРЦ	рж╢рзВржХрж░
ЁЯРЧ	рж╢рзВржХрж░
ЁЯРШ	рж╣рж╛рждрж┐
ЁЯРЩ	octopus
ЁЯРЪ	рж╕ржВржЦ
ЁЯРЫ	ржкрзЛржХрж╛
ЁЯРЬ	ржкрж┐ржкржбрж╝рзЗ
ЁЯРЭ	ржоржЙржорж╛ржЫрж┐
ЁЯРЮ	ржкрзЛржХрж╛
ЁЯРЯ	ржорж╛ржЫ
ЁЯРа	ржорж╛ржЫ
ЁЯРб	ржорж╛ржЫ
ЁЯРв	ржХржЪрзНржЫржк
ЁЯРг	ржорзБрж░ржЧрж┐рж░ ржмрж╛ржЪрзНржЪрж╛
ЁЯРд	ржорзБрж░ржЧрж┐рж░ ржмрж╛ржЪрзНржЪрж╛
ЁЯРе	ржорзБрж░ржЧрж┐рж░ ржмрж╛ржЪрзНржЪрж╛
ЁЯРж	ржкрж╛ржЦрж┐
ЁЯРз	penguin
ЁЯРи	koala
ЁЯРй	poodle
ЁЯРк	ржПржХржЯрж┐ ржХрзБржмрзНржЬ ржмрж╛рж▓рж╛ ржЙржЯ
ЁЯРл	ржжрзБржЗ ржХрзБржБржЬ ржЙржЯ
ЁЯРм	dolphin
ЁЯРн	ржЗржирзНржжрзБрж░рзЗрж░ ржорзБржЦ
ЁЯРо	ржЧрж░рзБрж░ ржорзБржЦ
ЁЯРп	ржмрж╛ржШрзЗрж░ ржорзБржЦ
ЁЯР░	ржЦрж░ржЧрзЛрж╢рзЗрж░ ржорзБржЦ
ЁЯР▒	ржмрж┐ржбрж╝рж╛рж▓рзЗрж░ ржорзБржЦ
ЁЯР▓	dragon ржПрж░ ржорзБржЦ
ЁЯР│	ржлрзЛржпрж╝рж╛рж░рж╛ ржУржпрж╝рж╛рж▓рж╛ рждрж┐ржорж┐
ЁЯР┤	ржШрзЛржбрж╝рж╛рж░ ржорзБржЦ
ЁЯР╡	ржмрж╛ржирзНржжрж░рзЗрж░ ржорзБржЦ
ЁЯР╢	ржХрзБржХрзБрж░рзЗрж░ ржорзБржЦ
ЁЯР╖	рж╢рзВржХрж░рзЗрж░ ржорзБржЦ
ЁЯР╕	ржмрзНржпрж╛ржЩрзЗрж░ ржорзБржЦ
ЁЯР╣	рж╣рж╛ржорзНрж╕рзНржЯрж░рзЗрж░ ржорзБржЦ
ЁЯР║	 ржирзЗржХржбрж╝рзЗрж░ ржорзБржЦ
ЁЯР╗	ржнрж╛рж▓рзНрж▓рзБржХрзЗрж░ ржорзБржЦ
ЁЯР╝	ржкрж╛ржирзНржбрж╛рж░ ржорзБржЦ
ЁЯР╜	рж╢рзВржХрж░рзЗрж░ ржирж╛ржХ
ЁЯР╛	ржерж╛ржмрж╛
ЁЯСА	ржЪрзЛржЦ
ЁЯСВ	ржХрж╛ржи
ЁЯСГ	ржирж╛ржХ
ЁЯСД	ржорзБржЦ
ЁЯСЕ	ржЬрж┐ржн
ЁЯСЖ	ржЖржЩрзНржЧрзБрж▓ ржжрж┐ржпрж╝рзЗ ржЙржкрж░ ржжрж┐ржХрзЗ ржЕржЩрзНржЧржнржЩрзНржЧрж┐
ЁЯСЗ	ржЖржЩрзНржЧрзБрж▓ ржжрж┐ржпрж╝рзЗ ржирж┐ржЪрзЗ ржЕржЩрзНржЧржнржЩрзНржЧрж┐
ЁЯСИ	ржЖржЩрзНржЧрзБрж▓ ржжрж┐ржпрж╝рзЗ ржмрж╛ржо ржжрж┐ржХрзЗ ржЕржЩрзНржЧржнржЩрзНржЧрж┐
ЁЯСЙ	ржЖржЩрзНржЧрзБрж▓ ржжрж┐ржпрж╝рзЗ ржбрж╛ржи ржжрж┐ржХрзЗ ржЕржЩрзНржЧржнржЩрзНржЧрж┐
ЁЯСК	ржорзБрж╖рзНржЯрж┐
ЁЯСЛ	hand waving
ЁЯСМ	ржарж┐ржХрзЗрж░ ржЪрж┐ржирзНрж╣
ЁЯСН	thumbs up ржПрж░ ржЪрж┐ржирзНрж╣
ЁЯСО	thumbs down ржПрж░ ржЪрж┐ржирзНрж╣
ЁЯСП	рждрж╛рж▓рж┐ ржмрж╛ржЬрж╛ржирзЛрж░
ЁЯСР	ржХрж░рждрж▓ ржЧрзБрж▓рзЛ
ЁЯСС	ржорзБржХрзБржЯ
ЁЯСТ	ржорж╣рж┐рж▓рж╛рж░ ржЯрзБржкрж┐
ЁЯСУ	ржЪрж╢ржорж╛
ЁЯСФ	ржирзЗржХржЯрж╛ржЗ
ЁЯСХ	рж╢рж╛рж░рзНржЯ
ЁЯСЦ	ржкрзНржпрж╛ржгрзНржЯ
ЁЯСЧ	ржкрзЛрж╢рж╛ржХ
ЁЯСШ	kimono
ЁЯСЩ	bikini
ЁЯСЪ	ржорж╣рж┐рж▓рж╛ржжрзЗрж░ ржХрж╛ржкржбрж╝
ЁЯСЫ	ржорж╛ржирж┐ржмрзНржпрж╛ржЧ
ЁЯСЬ	ржорж╣рж┐рж▓рж╛ ржжрзЗрж░ ржмрзНржпрж╛ржЧ
ЁЯСЭ	ржерж▓рж┐
ЁЯСЮ	рж▓рзЛржХрзЗрж░ ржЬрзБрждрзЛ
ЁЯСЯ	ржЦрзЗрж▓рж╛рж░ ржЬрзБржд
ЁЯСа	ржЙржЪрзНржЪ рж╣рж┐рж▓рзЗрж░ ржЬрзБрждрзЛ
ЁЯСб	ржорж╣рж┐рж▓рж╛рж░ ржЪржЯрж┐
ЁЯСв	ржорж╣рж┐рж▓рж╛рж░ ржмрзБржЯ
ЁЯСг	ржкржжрж╛ржЩрзНржХ
ЁЯСд	ржЕржжрзНржжрзЗржХ┬а┬аржорзВрж░рзНрждрж┐
ЁЯСе	ржЖржжрзНржзрзЗржХ ржорзБрж░рзНрждрж┐ржЧрзБрж▓рзЛ
ЁЯСж	ржЫрзЗрж▓рзЗ
ЁЯСз	ржорзЗржпрж╝рзЗ
ЁЯСи	ржкрзБрж░рзБрж╖┬а
ЁЯСй	ржорж╣рж┐рж▓рж╛
ЁЯСк	ржкрж░рж┐ржмрж╛рж░
ЁЯСл	ржнржжрзНрж░рж▓рзЛржХ ржЖрж░ ржнржжрзНрж░ржорж╣рж┐рж▓рж╛
ЁЯСм	ржжрзБржЯрзЛ ржкрзБрж░рзБрж╖
ЁЯСн	ржжрзБржЯрзЛ ржорж╣рж┐рж▓рж╛
ЁЯСо	ржкрзБрж▓рж┐рж╢ ржЕржзрж┐ржХрж╛рж░рзА
ЁЯСп	ржЦрж░ржЧрзЛрж╢рзЗрж░ ржХрж╛ржи ржкрж░рж╛ ржорзЗржпрж╝рзЗ
ЁЯС░	ржиржмржмржзрзВ
ЁЯС▒	рж╕рж╛ржжрж╛ ржЪрзБрж▓ржУржпрж╝рж╛рж▓рж╛ ржорж╛ржирзБрж╖
ЁЯС▓	ржкрзБрж░рзБрж╖┬а
ЁЯС│	ржкрзБрж░рзБрж╖┬а
ЁЯС┤	ржмрзБржбрж╝рзЛ рж▓рзЛржХ
ЁЯС╡	ржмрзБржбрж╝рж┐ ржорж╣рж┐рж▓рж╛
ЁЯС╢	ржмрж╛ржЪрзНржЪрж╛
ЁЯС╖	ржоржЬржжрзБрж░
ЁЯС╕	рж░рж╛ржЬржХрзБржорж╛рж░рзА
ЁЯС╣	ржжрзИрждрзНржп
ЁЯС║	ржкрзНрж░рзЗржд
ЁЯС╗	ржнрзВржд
ЁЯС╝	ржЫрзЛржЯ ржкрж░рзА
ЁЯС╜	ржмрж┐ржжрзЗрж╢рж┐┬а
ЁЯС╛	ржмрж┐ржжрзЗрж╢рж┐┬аржЕрж╕рзБрж░┬а
ЁЯС┐	ржЫрзЛржЯ ржнрзВржд
ЁЯТА	ржорж╕рзНрждржХ
ЁЯТБ	рждржерзНржп ржХрзЗржирзНржжрзНрж░
ЁЯТВ	ржЕржнрж┐ржнрж╛ржмржХ
ЁЯТГ	ржирж░рзНрждржХрзА
ЁЯТД	рж▓рж┐ржкрж╕рзНржЯрж┐ржХ
ЁЯТЕ	ржирзЗрж▓ ржкрж╛рж▓рж┐рж╢
ЁЯТЖ	ржЪрзЗрж╣рж╛рж░рж╛рж░ ржорзНржпрж╛рж╕рзЗржЬ
ЁЯТЗ	ржЪрзБрж▓ ржХрж╛ржЯрж╛ржирзЛ
ЁЯТИ	рж╕рзЗрж▓рзБржи
ЁЯТЙ	рж╕рзВржЪ
ЁЯТК	ржЧрзБрж▓рж┐
ЁЯТЛ	ржЪрзБржорзНржмржирзЗрж░ ржЫрж╛ржк
ЁЯТМ	ржкрзНрж░рзЗржо ржкрждрзНрж░
ЁЯТН	ржЖржВржЧржЯрж┐
ЁЯТО	ржоржирж┐
ЁЯТП	ржЪрзБржорзНржмржи
ЁЯТР	ржлрзБрж▓рзЗрж░ рждрзЛржбрж╝рж╛
ЁЯТС	ржжржорзНржкрждрж┐
ЁЯТТ	ржмрж┐ржпрж╝рзЗрж░ ржкрзБржЬрзЛрж░ ржЬрж╛ржПржЧрж╛
ЁЯТУ	рж╣рзГржжржпрж╝ ржзржХ ржзржХ ржХрж░рзЗ
ЁЯТФ	ржорж░рзНржоржШрж╛ржд
ЁЯТХ	ржжрзБржЗ рж╣рзГржжржпрж╝
ЁЯТЦ	ржЙржЬрзНржЬрзНржмрж▓ рж╣рзГржжржпрж╝
ЁЯТЧ	ржмрж╛ржбрж╝ржирзНржд рж╣рзГржжржпрж╝
ЁЯТШ	рж╣рзГржжржпрж╝ ржПржмржВ рждрзАрж░ржЪрж┐рж╣рзНржи
ЁЯТЩ	ржирзАрж▓ рж╣рзГржжржпрж╝
ЁЯТЪ	рж╕ржмрзБржЬ рж╣рзГржжржпрж╝
ЁЯТЫ	рж╣рж▓рзБржж рж╣рзГржжржпрж╝
ЁЯТЬ	ржмрзЗржЧрзБржирзА рж╣рзГржжржпрж╝
ЁЯТЭ	ржлрж┐рждрзЗрж░ рж╕ржЩрзНржЧрзЗ рж╣рзГржжржпрж╝
ЁЯТЮ	ржкрзБржирж░рж╛ржмрзГрждрзНрждрж┐ ржХрж░рж╛ рж╣рзГржжржпрж╝
ЁЯТЯ	рж╕ржЬрзНржЬрж┐ржд рж╣рзГржжржпрж╝
ЁЯТа	ржкрж╛ржкржбрж╝рж┐
ЁЯТб	ржмрж╛рж▓рзНржм
ЁЯТв	рж░рж╛ржЧ
ЁЯТг	ржмрзЛржорж╛
ЁЯТд	ржирж┐ржжрзНрж░рж╛рж▓рзБ
ЁЯТе	ржЯржХрзНржХрж░
ЁЯТж	ржШрж╛ржо ржЦрж░рж╛
ЁЯТз	ржЕржЩрзНржЧржмрж┐ржХрзГрждрж┐
ЁЯТи	running dash
ЁЯТй	poop
ЁЯТк	biceps
ЁЯТл	dizzy
ЁЯТм	speech balloon
ЁЯТн	thought balloon
ЁЯТо	flower stamp
ЁЯТп	full score
ЁЯТ░	money bag
ЁЯТ▒	currency exchange
ЁЯТ▓	dollar sign
ЁЯТ│	credit card
ЁЯТ┤	yen note
ЁЯТ╡	dollar note
ЁЯТ╢	euro note
ЁЯТ╖	pound note
ЁЯТ╕	flying money
ЁЯТ╣	rising market
ЁЯТ║	seat
ЁЯТ╗	p_letter c_letter
ЁЯТ╝	briefcase
ЁЯТ╜	m_letter d_letter
ЁЯТ╛	floppy disc
ЁЯТ┐	blu ray
ЁЯУА	d_letter v_letter d_letter
ЁЯУБ	file folder
ЁЯУВ	open folder
ЁЯУГ	document_nou
ЁЯУД	document_nou
ЁЯУЕ	calendar
ЁЯУЖ	tear_vrb off calendar
ЁЯУЗ	card index
ЁЯУИ	upward trend
ЁЯУЙ	downward trend
ЁЯУК	bar graph
ЁЯУЛ	clipboard
ЁЯУМ	pushpin
ЁЯУН	round pushpin
ЁЯУО	paperclip
ЁЯУП	straight ruler
ЁЯУР	triangle ruler
ЁЯУС	bookmark tabs
ЁЯУТ	ledger
ЁЯУУ	notebook
ЁЯУФ	decorated notebook
ЁЯУХ	closed book
ЁЯУЦ	open book
ЁЯУЧ	green book
ЁЯУШ	book
ЁЯУЩ	orange book
ЁЯУЪ	books
ЁЯУЫ	name badge
ЁЯУЬ	scroll
ЁЯУЭ	memo
ЁЯУЮ	phone
ЁЯУЯ	pager
ЁЯУа	fax
ЁЯУб	satellite dish
ЁЯУв	loudspeaker
ЁЯУг	megaphone
ЁЯУд	sent mail
ЁЯУе	inbox
ЁЯУж	package
ЁЯУз	email
ЁЯУи	incoming mail
ЁЯУй	outgoing mail
ЁЯУк	mailbox
ЁЯУл	mailbox
ЁЯУм	mailbox
ЁЯУн	mailbox
ЁЯУо	postbox
ЁЯУп	postal horn
ЁЯУ░	newspaper
ЁЯУ▒	cell phone
ЁЯУ▓	cell phone with arrow
ЁЯУ│	vibration mode
ЁЯУ┤	phone off
ЁЯУ╡	no cell phone
ЁЯУ╢	mobile signals
ЁЯУ╖	camera
ЁЯУ╣	video cam
ЁЯУ║	t_letter v_letter
ЁЯУ╗	radio
ЁЯУ╝	video tape
ЁЯФА	crossed arrows
ЁЯФБ	clockwise arrows
ЁЯФВ	clockwise arrows
ЁЯФГ	reload
ЁЯФД	anti clockwise arrows
ЁЯФЕ	low brightness
ЁЯФЖ	high brightness
ЁЯФЗ	no speaking
ЁЯФИ	speaker
ЁЯФЙ	speaker
ЁЯФК	speaker
ЁЯФЛ	battery
ЁЯФМ	electric plug
ЁЯФН	magnifying glass
ЁЯФО	magnifying glass
ЁЯФП	lock
ЁЯФР	closed lock
ЁЯФС	key
ЁЯФТ	lock
ЁЯФУ	lock
ЁЯФФ	bell
ЁЯФХ	no bell
ЁЯФЦ	bookmark
ЁЯФЧ	link sign
ЁЯФШ	radio button
ЁЯФЩ	back
ЁЯФЪ	end
ЁЯФЫ	on arrow
ЁЯФЬ	soon sign
ЁЯФЭ	top sign
ЁЯФЮ	no one under eighteen
ЁЯФЯ	keycap ten
ЁЯФа	uppercase letters
ЁЯФб	lowercase letters
ЁЯФв	numbers
ЁЯФг	symbols
ЁЯФд	latin alphabet
ЁЯФе	fire
ЁЯФж	flashlight
ЁЯФз	wrench
ЁЯФи	hammer
ЁЯФй	nut and bolt
ЁЯФк	cooking knife
ЁЯФл	gun
ЁЯФм	microscope
ЁЯФн	telescope
ЁЯФо	crystal ball
ЁЯФп	six pointed star
ЁЯФ░	green and yellow leaf
ЁЯФ▒	trident sign
ЁЯФ▓	square button
ЁЯФ│	square button
ЁЯФ┤	large circle
ЁЯФ╡	large circle
ЁЯФ╢	large diamond
ЁЯФ╖	large diamond
ЁЯФ╕	small diamond
ЁЯФ╣	small diamond
ЁЯФ║	up triangle
ЁЯФ╗	down triangle
ЁЯФ╝	up triangle
ЁЯФ╜	down triangle
ЁЯХР	one o'clock
ЁЯХС	two o'clock
ЁЯХТ	three o'clock
ЁЯХУ	four o'clock
ЁЯХФ	five o'clock
ЁЯХХ	six o'clock
ЁЯХЦ	seven o'clock
ЁЯХЧ	eight o'clock
ЁЯХШ	nine o'clock
ЁЯХЩ	ten o'clock
ЁЯХЪ	eleven o'clock
ЁЯХЫ	twelve o'clock
ЁЯХЬ	one thirty
ЁЯХЭ	two thirty
ЁЯХЮ	three thirty
ЁЯХЯ	four thirty
ЁЯХа	five thirty
ЁЯХб	six thirty
ЁЯХв	seven thirty
ЁЯХг	eight thirty
ЁЯХд	nine thirty
ЁЯХе	ten thirty
ЁЯХж	eleven thirty
ЁЯХз	twelve thirty
ЁЯЧ╗	mount fuji
ЁЯЧ╝	tokyo tower
ЁЯЧ╜	statue of liberty
ЁЯЧ╛	map of japan
ЁЯЧ┐	moyai statue
ЁЯША	grin
ЁЯШБ	grin
ЁЯШВ	tears_nou of joy
ЁЯШГ	open mouth_nou smile
ЁЯШД	open mouth_nou smile
ЁЯШЕ	cold sweat smile
ЁЯШЖ	open mouth_nou smile
ЁЯШЗ	smile with a_determiner halo
ЁЯШИ	smile with horns
ЁЯШЙ	winking face
ЁЯШК	smile
ЁЯШЛ	yummy face
ЁЯШМ	relieved face
ЁЯШН	smiling face
ЁЯШО	cool
ЁЯШП	smirk
ЁЯШР	deadpan face
ЁЯШС	expressionless
ЁЯШТ	unamused
ЁЯШУ	cold sweat
ЁЯШФ	pensive face
ЁЯШХ	confused face
ЁЯШЦ	confounded face
ЁЯШЧ	kissy face
ЁЯШШ	throwing kisses
ЁЯШЩ	kiss and smile
ЁЯШЪ	kissing
ЁЯШЫ	tongue out
ЁЯШЬ	tongue out
ЁЯШЭ	yuck
ЁЯШЮ	disappointed
ЁЯШЯ	worried
ЁЯШа	angry
ЁЯШб	pouting
ЁЯШв	crying
ЁЯШг	blew it
ЁЯШд	look of triumph
ЁЯШе	whew
ЁЯШж	frowning face
ЁЯШз	anguished
ЁЯШи	fearful
ЁЯШй	weary
ЁЯШк	sleepy
ЁЯШл	tired
ЁЯШм	grimace
ЁЯШн	loudly crying
ЁЯШо	open mouth_nou face
ЁЯШп	hushed face
ЁЯШ░	rushed face
ЁЯШ▒	fearful face
ЁЯШ▓	astonished face
ЁЯШ│	flushed
ЁЯШ┤	sleeping
ЁЯШ╡	dizzy
ЁЯШ╢	no mouth_nou face
ЁЯШ╖	face with mask
ЁЯШ╕	grinning cat face
ЁЯШ╣	tears_nou of joy
ЁЯШ║	smiling cat face
ЁЯШ╗	smiling cat face
ЁЯШ╝	wry cat face
ЁЯШ╜	kissing cat
ЁЯШ╛	pouting cat face
ЁЯШ┐	crying cat face
ЁЯЩА	weary cat face
ЁЯЩЕ	no good gesture
ЁЯЩЖ	okay gesture
ЁЯЩЗ	i'm sorry
ЁЯЩИ	see no evil
ЁЯЩЙ	hear no evil
ЁЯЩК	speak no evil
ЁЯЩЛ	happy person
ЁЯЩМ	hooray
ЁЯЩН	frowning
ЁЯЩО	pouting
ЁЯЩП	folded hands
ЁЯЪА	rocket
ЁЯЪБ	helicopter
ЁЯЪВ	steam locomotive
ЁЯЪГ	train
ЁЯЪД	high speed train
ЁЯЪЕ	high speed train
ЁЯЪЖ	train
ЁЯЪЗ	subway
ЁЯЪИ	light rail
ЁЯЪЙ	train station
ЁЯЪК	tram
ЁЯЪЛ	tram car
ЁЯЪМ	bus
ЁЯЪН	oncoming bus
ЁЯЪО	trolleybus
ЁЯЪП	bus stop
ЁЯЪР	minibus
ЁЯЪС	ambulance
ЁЯЪТ	fire engine
ЁЯЪУ	police car
ЁЯЪФ	oncoming police car
ЁЯЪХ	taxi
ЁЯЪЦ	oncoming taxi
ЁЯЪЧ	car
ЁЯЪШ	oncoming car
ЁЯЪЩ	r_letter v_letter
ЁЯЪЪ	delivery truck
ЁЯЪЫ	lorry
ЁЯЪЬ	tractor
ЁЯЪЭ	monorail
ЁЯЪЮ	mountain railway
ЁЯЪЯ	suspension railway
ЁЯЪа	mountain cableway
ЁЯЪб	cable car
ЁЯЪв	ship
ЁЯЪг	rowboat
ЁЯЪд	speedboat
ЁЯЪе	traffic lights
ЁЯЪж	traffic lights
ЁЯЪз	under construction
ЁЯЪи	revolving light
ЁЯЪй	location flag
ЁЯЪк	door
ЁЯЪл	no entry sign
ЁЯЪм	smoking sign
ЁЯЪн	no smoking sign
ЁЯЪо	litterbox sign
ЁЯЪп	don't litter sign
ЁЯЪ░	drinking water
ЁЯЪ▒	non drinking water
ЁЯЪ▓	bike
ЁЯЪ│	no bike
ЁЯЪ┤	bicyclist
ЁЯЪ╡	mountain bicyclist
ЁЯЪ╢	pedestrian
ЁЯЪ╖	no pedestrians
ЁЯЪ╕	children crossing
ЁЯЪ╣	men sign
ЁЯЪ║	women sign
ЁЯЪ╗	restroom sign
ЁЯЪ╝	baby sign
ЁЯЪ╜	toilet
ЁЯЪ╛	water closet
ЁЯЪ┐	shower
ЁЯЫА	bath
ЁЯЫБ	bathtub
ЁЯЫВ	passport control
ЁЯЫГ	customs
ЁЯЫД	baggage claim
ЁЯЫЕ	left luggage
	flag of japan
є╛Уж	flag of the u_letter s_letter
є╛Уз	flag of france
є╛Уи	flag of germany
є╛Уй	flag of italy
є╛Ук	flag of united kingdom
є╛Ул	flag of spain
є╛Ум	flag of russia
є╛Ун	flag of china
є╛Уо	flag of south korea
є╛ам	hash key
є╛ао	keycap one
є╛ап	keycap two
є╛а░	keycap three
є╛а▒	keycap four
є╛а▓	keycap five
є╛а│	keycap six
є╛а┤	keycap seven
є╛а╡	keycap eight
є╛а╢	keycap nine
є╛а╖	keycap zero
тГг	combining enclosing keycap
тДв	trade mark sign
тМЪ	watch
тМЫ	hourglass
тПй	fast forward
тПк	rewind_nou
тПл	up arrow
тПм	down arrow
тП░	alarm clock
тП│	sand timer
тШБ	cloud
тШ║	smiling face
тЩИ	aries
тЩЙ	taurus
тЩК	gemini
тЩЛ	cancer
тЩМ	leo
тЩН	virgo
тЩО	libra
тЩП	scorpion
тЩР	sagittarius
тЩС	capricorn
тЩТ	aquarius
тЩУ	pisces
тЩ╗	recycling symbol
тЩ┐	wheelchair access
тЪУ	anchor
тЪа	warning sign
тЪб	high voltage
тЪ╜	soccer ball
тЪ╛	baseball
тЫД	snowman
тЫЕ	sun behind clouds
тЫО	ophiuchus
тЫФ	no entry sign
тЫк	church
тЫ▓	fountain
тЫ│	flag in hole
тЫ╡	sailboat
тЫ║	tent
тЫ╜	gas station
тЬЕ	check mark
тЬК	rock
тЬЛ	paper
тЬМ	scissor
тЬи	one
тЭМ	cross mark
тЭО	cross mark
тЭУ	question mark
тЭФ	question mark
тЭХ	exclamation mark
тЮХ	plus
тЮЦ	minus
тЮЧ	division
тЮ░	curly loop
тЮ┐	double curly loop
уА░	wavy dash
